##########
#--------#
##-#-###-#
#--#-#-#-#
##-#-#-#-#
#------#-#
########-#
#--------#
##-#-#-#-#
##########
